+-+-+-+-+-+-+-+-+-+-+-+-+-+-+-+-+-+-+-+-+-+-+-+-+-+
            |   |       |     |       |       |   |
+-+-+-+-+-+ +-+ + +-+-+ + +-+ + +-+ + + +-+-+ + + +
|     |     |   | |     | |   | | | | |   |     | |
+ + + +-+-+ + +-+ + +-+-+ + +-+ + + + +-+-+ +-+-+ +
| | | |     |   | | |   | | |   |   |       |     |
+ +-+ + +-+-+-+ + + +-+ + + + +-+-+-+-+-+ +-+ +-+-+
| |   |   |     | |   | | | | |           |   |   |
+ + +-+ + +-+ + + +-+ + + + + + + +-+-+-+-+ +-+-+ +
| |   | | |   | | |   | | |   | | |   |           |
+ +-+ +-+ + +-+ +-+ +-+ + +-+-+ + + +-+ +-+ +-+-+-+
|   |     |   |         | |     | |     | | |   | |
+-+ +-+-+-+-+ +-+-+ +-+ + + +-+-+ +-+-+-+ + + + + +
|           | |   |   |   |   |   |   |   |   | | |
+ +-+-+ +-+ + + + +-+ +-+-+-+ + +-+ + + +-+-+ + + +
| | |     | |   | |   |       | |   | |       |   |
+ + + +-+ + + +-+ + +-+-+-+-+-+ + + + +-+-+-+-+-+-+
| | | |   | | | |       |     | | | |       |     |
+ + + + +-+ + + +-+ +-+ + +-+ + + +-+-+-+-+ + +-+ +
|   | |   |   |   | |   |   | |   |     |       | |
+-+-+ +-+ +-+-+-+ +-+ +-+-+-+ +-+-+ +-+ + +-+ + +-+
|   |   | |     |     |     | |   |   | |   | |   |
+ + +-+-+ + +-+ +-+ +-+-+-+ + +-+ +-+-+ +-+ + +-+ +
|         |   |     |   |     |     |   |     |    
+-+-+-+-+-+-+-+-+-+-+-+-+-+-+-+-+-+-+-+-+-+-+-+-+-+

